#########################################
#   #       #       #                   #
# # # # ##### ##### # ### ##### ####### #
# #   # #     #     # # #   #   #     # #
# ####### ##### ### # # ### # ### ### ###
#     #   # #   #   # #   # #   #   #   #
# ### # ### # ### ### # ### ####### ### #
#   # #   # # #   #   #   #         #   #
### # ### # # ##### ##### ########### ###
#   # #     #   #           #       #   #
# ### # ####### # ########### ##### ### #
# # #     #   #   #     #     # #   #   #
# # ####### # ##### ### # ##### # ### ###
# #   #     #       #   #     # # #     #
# ### # ############# ### ### # # # ### #
#   # #   #       #   #     # # # # #   #
### # ### # ##### # ### ##### # # # # ###
#   # #   # #     #   # #     #   # #   #
# ### # ### ##### ### # # ##### ##### # #
#     # # #     #     # #     #     # # #
####### # ##### ### ### ##### ##### ### #
#     # #   # #   # # #     #     #   # #
# ### # # # # ### # # ##### ##### ### # #
# #   #   # #   # # # #   #     # #   # #
# # # ##### # ### ### # # ####### # ### #
# # #     # #   #   #   #     #   # #   #
# # ##### # # # ### ######### # ### ### #
# # #     # # #   #   #     # #   #   # #
# # ####### ##### ### # # ### ### ### # #
# # #     #       # #   #     #   #   # #
# # # ### ####### # ########### ### ### #
# #   #         # #     #       # # #   #
# ##### ######### # ### # ####### # # # #
# #   # #       # # #   #     # #   # # #
# # # # # ##### # # ### ##### # # ### ###
#   # #   #   #   #   # #     # #   #   #
##### ##### # ##### # # # ##### ### ### #
#   # #     #   #   # #   # #     #     #
# # # ### ##### ##### ##### # # ####### #
# #       #           #       #         #
#########################################
